NO ./image.png
SO ./image.png

WE ./image.png
EA ./image.png

F 220,100,0
C 225,30,0


    
     


        1111111111111111111111111
        1000000000110000000000001
        1011000001110000000000001
        1001000000000000000000001
1111111110110000011100000000000001
100000000011000001110111111111111
11110111111111011101110010001
11110111111111011101 10010001
11000000110101011101110010001
10000000000000001100000010001
10000000000000001101010010001
11000001110101011111011110N0111
11110111 1110101 10111101000001
11111111 1111111 11111111111111